1111111111111
1C00001C10001
10000000P0001
1111011111111
1C000000000C1
1111111111101
1E00000000001
1111111111111
